WE /Users/aikram/Desktop/final_cub_v69/textures/jmyao.xpm
SO /Users/aikram/Desktop/final_cub_v69/textures/jmyao.xpm
EA /Users/aikram/Desktop/final_cub_v69/textures/jmyao.xpm
NO /Users/aikram/Desktop/final_cub_v69/textures/jmyao.xpm

F 18,53,25
C 153,204,255

111111111111
100000000011
10000000001
100000000001
10S000000001
111111111111
110000000001
11111111111