NO ./textures/jmyao.xpm
SO ./textures/jmyao.xpm
WE ./textures/wefuk/muha.xpm
EA ./textures/wefuk/alien_tymr.xpm

C 235, 245, 247
F 44, 56, 3

1111111
1111N11
1111011 
1000001
1111111