NO ./textures/1.xpm
WE ./textures/dark2.xpm
SO ./textures/2.xpm
EA ./textures/dark1.xpm

F 0, 0, 0
C 0, 0, 0

1111111111111111111 1
100010000000110000111
110010000000110000001
110000000011000100111
111000100000000000111
111000000000111000111
111100000000110000001
100000000000111100111
10000N000000110000001
100001000000110000001
111111111111111111111










tf_this2.xpm
tf_this3.xpm
